URTelegram	KEYWORD1

setTelegramToken	KEYWORD2
useDNS	KEYWORD2
enableUTF8Encoding	KEYWORD2

setStatusPin	KEYWORD2
testConnection	KEYWORD2
getNewMessage	KEYWORD2
sendMessage	KEYWORD2
sendSticker	KEYWORD2
endQuery	KEYWORD2
setFingerprint	KEYWORD2
flushData	KEYWORD2
addRow	    KEYWORD2
addButton	KEYWORD2
getJson	    KEYWORD2
getPretty	KEYWORD2

TBUser	KEYWORD3
TBMessage	KEYWORD3
TBLocation	KEYWORD3
MessageType	KEYWORD3

MessageNoData	LITERAL1
MessageText	LITERAL1
MessageQuery	LITERAL1
MessageLocation	LITERAL1

